0000000000
1100110000
0000110200
3000011000
1100110000
1100110000
